OOMMMMMMMMMMMMMMMMMMMMMMMMMMMMMM
OMMMPPMMMMMCMMMMWMMMMMMMMMMMCMMM
MMP1PWPPPPPPMMMCPPPPMMMWPPMMPMMM
MP1HCPPMMMPPPPMMPCPPPPPPPPPPPMMM
MPPCPPPMMMMMMPMPPMMMMMPPPPMMPMMM
MPWPPPPMMCCMMPPPPPMMMMCCCMMMPPMM
MMPPMMPPMMMMMPMMPMMMMMMMMMMMMPPM
MMPMMMPPPPPPPPMMPMMMMMMMMMMMMPCM
MMPMMMCCCMMMPMMMPMMPMMMMMMCMMPPM
MPPMCMMMMMMMPMMMPPPPPPMMMMPMPPPM
MPMMMMMMMMMPPPPPPPMMMPPPPMPPPWPM
MPPPMMMMPMMPMPMPPCMMMMMMPPPPCPMM
MCMPPPPPwPPPMPMCPMMMCPPMPPPCH2MM
MMMMMMMCMMMMMMMMWMMMMCCMMPWP2MMO
MMMMMMMMMMMMMMMMMMMMMMMMMMMMMMOO