OOOOOOOOOOOOOOOOOOO
OOOOOOOOOOOOPFPWPFO
OOOOOOOOCRRRRRRRHPO
OOOOOOOMPRPFPCWPPCO
OOOOOFPFFRCPPFPFPOO
OOFPPPFPCRFFFPOOOOO
OCPPWCFFPRPMOOOOOOO
OPHRRRRRRRCOOOOOOOO
OFPWPFPOOOOOOOOOOOO
OOOOOOOOOOOOOOOOOOO