ORRFPPPCPFROORCPPRRRR
OOOPPCFPPPWRRCPPPFPCP
CORCPPPPMPFPPRFPPCRRP
PPWRRPMMF1PPFRPMPPCPP
PWOPRRMSSPPPCAPMPPCPP
FPOLPRRSSFHMPFPCMPPPF
PCPRFPCPPFMFPPPPMMFPP
PRRRPDPPAMPSSMRFPMPDC
RRPLCRRMSSOSSMRRCLPRR
CDPMPFRMSSPMAPPDPRRRP
PPFMMPPPPFMFPPCPFRPCP
FPPPMCPFPMHFSSRRPLOPF
PPCPPMPACPPPSSMRRPOWP
MPPPFPPRFPP2FMMPRRWPP
PRRCPPFRPPFPMPPPPCROC
PCPFPPPCRRWPPPFCPPOOO
RRRRPPCROORFPCPPPFRRO