FFFFPPLPPFFFFFFFFFFFFFFFFPSLPPFF
FFFFPPRPPPPPPPPPPFFFPFPPPPPLPFFF
FFPPPPLPPCCCCCCCPPPPWPCCCCPRPPPF
FFPWPPLLSSSPPPPPSLLLLLPPPPSLPWPF
FFCPPPSLLLLLLLLLLLSSSLLLLLLLPPPF
FFFPPPPPPRPPPSPPSSPPPPSSLSSPPPPF
FFFPPMPPPLSSPPPSPPPCPPPPRPCPP2PF
FFPPPMPPPLLLLLLCCPCPLLLLLPFPCH2F
FFCPWMPPSLLSSSLLLSPSLSSLSPPPPCFF
F1HCPPPPLLLPPSSSLLLLLPPRPPPPWFFF
FF1PPPPPRPPPPPPSLSPPPPSLLLLPPPFF
FPPPPSLLLPPPMPPLLPPPPSLLSSLSPCPF
FPCPPSLSSPPMPPPRPPCPLLLSSSLLPPFF
FFPCPSLSFFCPPWPLPPPSLSSSCSSLPCPF
FFFFPPLPFFFFFFSLSFFSLSFFFFSLSPFF