OOOOOOOOOO
OOOOOOOOOO
OOOOOOOOOO
OOOHWFMOOO
OOOWRMFOOO
OOOFMRWOOO
OOOMFWHOOO
OOOOOOOOOO
OOOOOOOOOO
OOOOOOOOOO