RRRCRRRRRRRCRRR
ROOOROOROOROOOR
RRRRRRWHWRRRRRR
ROOCOOOROOOCOOR
RCRRRRRRRRRRRWR
ROOOROOROOROOOR
ROOORORRROROOOR
RRRRRRRORRRRRRR
ROOORORRROROOOR
ROOOROOROOROOOR
RWRRRRRRRRRRRCR
ROOCOOOROOOCOOR
RRRRRRWHWRRRRRR
ROOOROOROOROOOR
RRRCRRRRRRRCRRR