MMMMFPPPPPPPP2P
MMMFPRRRRRRRWH2
MMFPPRFMCPPPPWP
MFPPMRFMMMMMMRF
FPPMFRFMFRRRRRF
FPMFCRRRRRCFMPF
FRRRRRFMFRFMPPF
FRMMMMMMFRMPPFM
PWPPPPCMFRPPFMM
1HWRRRRRRRPFMMM
P1PPPPPPPPFMMMM