OOOOOOOOOOOOOOOO
OOMFRRRRRPFPW2OO
OPPFRFOPRCPPPH2O
OCCRROOORPMFPRWO
OPPRPOOORCMMCRPO
OWRRCOOFRRRRRRCO
O1HPPPCFFPOOOROO
OO1WPPPPPPOOFRMO
OOOOMCCMFPRRRCCO
OOOOOOOOOOOOOOOO